40
40
22 22 22 22 22 22 22 22 22 22 22 22 22 22 22 22 22 22 22 22 22 22 22 22 22 22 22 22 22 22 22 22 22 22 22 22 22 22 22 22 
22 22 22 22 22 22 22 22 22 22 22 22 22 22 22 22 22 22 22 22 22 22 22 22 22 22 22 22 22 22 22 22 22 22 22 22 22 22 22 22 
21 21 21 21 21 21 21 21 21 21 21 21 21 21 21 21 21 21 21 21 21 21 21 21 21 21 21 21 21 21 21 21 21 21 21 21 21 21 21 21 
1 1 1 1 2 1 1 1 1 1 1 1 1 1 1 1 1 1 1 1 1 1 1 1 1 1 1 2 1 1 1 1 1 1 1 1 1 1 1 1 
20 20 1 1 2 1 1 1 1 2 2 2 2 2 20 20 20 20 20 1 2 2 2 2 2 2 2 2 2 2 2 2 2 2 2 2 1 1 20 20 
20 20 2 2 2 1 2 1 2 2 2 2 2 2 20 20 20 20 20 1 1 1 1 1 1 2 1 2 2 2 1 1 2 2 2 2 1 20 20 20 
20 20 20 2 1 20 20 20 20 2 2 2 2 20 20 20 20 20 1 2 2 2 2 20 20 1 1 2 2 2 1 1 2 1 1 1 20 20 20 20 
20 20 20 20 20 20 20 20 20 20 2 2 2 20 20 20 20 20 1 1 20 20 20 20 20 20 20 2 2 2 20 20 20 20 20 20 20 20 20 20 
20 20 20 20 20 20 20 20 20 20 2 2 2 20 20 20 20 20 1 2 20 20 20 20 20 20 20 2 2 2 20 20 20 20 20 20 20 20 20 20 
20 20 20 20 20 20 20 20 20 1 2 2 2 2 1 20 20 20 1 2 20 20 20 20 20 20 2 2 2 2 20 20 20 20 20 20 20 20 20 20 
20 20 20 1 1 1 1 20 20 1 1 2 2 2 1 20 20 1 1 1 1 20 20 20 20 2 2 2 2 2 20 20 20 20 1 1 20 20 20 20 
20 20 1 2 2 2 2 20 20 1 2 2 2 2 2 20 20 1 2 2 1 1 20 20 20 2 2 2 2 20 20 20 20 1 2 1 1 20 20 20 
20 20 1 2 2 2 2 1 1 1 2 2 2 2 2 2 1 1 1 2 1 2 20 20 20 2 2 20 20 20 20 20 20 1 2 1 1 2 20 20 
20 20 1 1 2 2 2 20 20 2 2 2 2 2 2 2 2 2 2 2 1 1 20 20 20 2 1 20 20 1 1 2 2 1 2 1 1 1 20 20 
20 20 20 1 1 1 1 20 20 2 2 2 2 2 1 20 20 2 1 1 1 20 20 20 20 1 2 1 20 1 20 20 20 1 1 1 1 20 20 20 
20 20 20 20 1 20 20 20 20 20 20 20 20 20 2 20 1 1 20 20 20 20 20 20 20 20 20 1 20 2 20 20 20 20 20 1 2 20 20 20 
20 20 20 20 1 20 20 20 20 20 20 20 20 20 1 20 1 1 20 20 20 20 20 20 20 20 20 1 20 1 20 20 20 20 20 2 1 20 20 20 
20 20 20 20 1 20 20 20 20 20 20 1 1 2 1 20 20 1 1 1 1 1 1 20 20 2 2 2 20 1 20 20 20 20 20 2 1 20 20 20 
20 20 2 1 1 20 20 20 20 20 1 1 20 20 20 20 20 1 2 1 2 1 1 20 20 2 20 20 20 2 1 1 1 20 20 2 1 20 20 20 
20 2 1 2 1 2 1 1 1 1 1 1 1 1 1 1 1 1 2 2 2 2 1 1 1 2 1 1 1 1 1 1 1 1 1 1 1 1 1 20 
20 20 1 1 1 1 1 1 1 2 1 20 20 20 1 1 1 1 1 2 2 2 1 20 20 1 20 1 1 1 1 20 20 20 20 20 2 20 20 20 
20 20 1 1 1 1 1 1 1 1 1 1 20 20 20 20 20 1 1 2 2 1 1 20 20 2 20 20 20 20 20 20 20 20 20 20 2 20 20 20 
20 20 20 20 20 20 20 20 20 20 20 1 20 20 20 20 20 1 1 1 1 1 1 20 20 1 1 1 1 1 1 20 20 20 20 20 2 20 20 20 
20 20 20 20 20 20 20 20 20 20 20 1 20 20 20 20 20 20 20 20 20 20 20 20 20 20 20 20 20 20 1 20 20 20 20 20 2 20 20 20 
20 20 20 20 20 20 20 20 20 20 20 1 20 20 20 20 20 20 20 1 1 20 20 20 20 20 20 20 20 20 1 20 20 20 20 20 2 20 20 20 
20 20 20 2 1 20 20 20 20 20 20 1 1 20 20 20 20 20 1 1 1 20 20 20 20 20 20 20 20 20 1 20 20 20 20 20 2 2 1 20 
20 20 20 2 2 20 20 20 20 1 2 1 1 1 20 20 20 20 1 2 1 1 20 20 20 20 1 1 2 1 1 20 20 20 20 20 2 2 2 20 
20 20 20 2 2 20 20 20 20 20 20 20 20 20 20 20 20 20 20 20 20 20 20 20 20 20 20 20 20 20 20 20 20 20 20 20 20 20 20 20 
20 20 1 2 1 2 1 20 1 1 1 1 1 1 1 20 20 1 2 1 1 2 20 20 20 1 1 2 1 1 1 1 2 1 2 20 20 20 20 20 
20 20 20 1 1 1 1 20 20 20 1 1 1 1 1 1 1 1 1 1 1 1 20 20 20 1 1 1 2 1 20 20 20 1 1 1 1 1 1 20 
20 20 20 1 1 2 1 20 20 20 20 1 1 20 20 20 20 1 20 20 20 1 1 1 1 1 1 1 1 20 20 20 20 1 1 1 1 1 20 20 
20 20 20 20 20 20 20 20 20 20 20 20 20 20 20 20 20 20 20 20 20 20 20 20 20 20 20 20 20 20 20 20 20 20 20 1 1 1 20 20 
20 20 20 20 20 20 20 20 20 20 20 20 20 20 20 20 20 20 20 20 20 20 20 20 20 20 20 20 20 20 20 20 20 20 20 20 20 20 20 20 
20 20 20 1 1 20 20 20 20 20 20 20 20 20 1 1 1 1 20 20 20 1 1 1 1 1 1 20 20 20 20 20 20 20 1 1 1 1 1 1 
20 20 1 1 1 20 20 20 20 20 20 1 1 1 2 20 20 20 20 20 20 1 1 1 1 1 2 1 20 20 20 20 20 20 1 1 1 1 1 1 
20 20 2 1 1 20 20 20 20 20 20 1 20 20 20 20 20 20 20 20 1 2 1 1 1 1 1 1 1 20 20 20 20 20 1 1 1 1 1 1 
20 20 1 1 2 1 20 20 20 20 20 1 20 20 20 20 20 20 20 20 1 1 1 1 1 1 2 1 1 20 20 20 20 20 20 1 1 1 20 20 
20 20 20 1 1 1 1 1 1 1 2 1 20 20 20 20 20 20 20 20 20 1 1 1 1 1 2 1 20 20 20 20 20 20 20 1 1 1 20 20 
20 20 20 20 1 2 20 20 20 20 20 20 20 20 20 20 20 20 20 20 20 20 20 20 20 1 1 20 20 20 20 20 20 20 20 20 1 20 20 20 
20 20 20 20 20 20 20 20 20 20 20 20 20 20 20 20 20 20 20 20 20 20 20 20 20 20 20 20 20 20 20 20 20 20 20 20 20 20 20 20 
